@SSSSSSSSSSSS
SSSSSSSSSSSSS
SSWcbWWWwWdWWS
SSWFFFFFFFFFWS
SSWFFFFFFFFFWS
SSWFFFFFFFFFWS
SSWcbWWWwWdWWS
SSSSSSSSSSSSSS